0 0 0 1 1 
1 1 0 0 F 
0 1 0 1 1 
1 0 0 0 F 
1 F 1 1 1 